90
10
0
8
89
8
|^ ^ ^ ^ ^ ^ ^ ^ ^|^ ^ ^ ^|^ ^ ^ ^ ^ ^ ^ ^ ^|^|^ ^ ^ ^|^ ^ ^ ^ ^ ^|^ ^ ^ ^ ^ ^ ^ ^|^ ^ ^ ^|^ ^ ^ ^ ^|^ ^ ^ ^ ^|^ ^ ^ ^ ^|^ ^ ^ ^|^ ^ ^ ^ ^|^ ^|^ ^ ^ ^|^ ^ ^|^ ^|^ ^|^ ^ ^|^ ^ ^ ^ ^
| |^ ^ ^|^ ^ ^ ^|^ ^ ^ ^  |^ ^   ^ ^ ^ ^ ^| | | | |^ ^   ^ ^| |^ ^ ^ ^ ^ ^ ^ ^ ^| | |^ ^| |^| |^  | |^|^  |^  |  ^ ^ ^|  ^|  ^ ^   ^ ^ ^| | | | |^ ^ ^|  ^ ^  |^  |  ^|^   ^ ^|  ^ ^
|  ^|  ^  |^ ^| | |^ ^ ^  | |^  |^ ^|  ^|  ^|  ^|   |^ ^ ^| | |  ^ ^|^   ^ ^|^  | | | | |^  |^  | | | | | | |^   ^ ^|  ^| | |^   ^ ^ ^| | | |   |  ^|^  |  ^| | | |^|^  |^ ^|  ^|^  
|^| | |  ^ ^|     | |^ ^| | | |^| |  ^| |^| | |^  |^  |^  |  ^ ^ ^ ^| |^ ^ ^   ^    |  ^| | | |^|  ^  | | | | |^ ^|  ^| | |^   ^ ^|^| |  ^  |^ ^| | | |^  | | | |   | |^ ^  |^| | |^
| | | |  ^ ^ ^ ^ ^|^ ^  | | |   | | |  ^|   | | |^ ^ ^  |^ ^| |^ ^| |  ^ ^ ^ ^| |^ ^ ^| | |^  |   |^ ^  | | |  ^| |^ ^| |^  |^ ^ ^  |  ^| | | | | |   | | | | | | | |   |  ^| |     
| |  ^  |^ ^ ^ ^| | |^ ^| |  ^|^  |  ^ ^  | | | | |^ ^|  ^| | |^|    ^|^ ^ ^  | |^ ^  | | | |^  | | |^| |  ^ ^| | | | | | | | |^ ^   ^| | | | | | | | | | |^  | |  ^ ^| |^ ^  | |^ ^
|  ^ ^|^  | |^| |   | | | | |^ ^|  ^|  ^| |  ^| | | |  ^| | | |  ^ ^ ^  |  ^|^    |^ ^  |   |^| | | | | |^|^| |   | | |  ^| | | |^ ^  | | | | | |^  | |^| |^ ^  |^|^| |   |^ ^  | | 
|^ ^|    ^|   | | |^| | | |   | |  ^ ^|  ^ ^|^    |  ^ ^  | |  ^ ^|^  |^  | | |^ ^  |^ ^   ^  | | |   | | |    ^|   |^  | |   |^  |^  | |  ^|  ^   ^ ^  | |  ^| | |    ^| |^ ^   ^  
|  ^  |^ ^ ^| |   | | | |   |^   ^|  ^ ^ ^ ^ ^ ^ ^ ^ ^  |^  |^   ^  |^  |^| |   |  ^ ^  |^ ^|^| |  ^ ^  |  ^ ^|  ^  |  ^ ^ ^ ^ ^ ^  | |  ^|  ^  |^ ^ ^ ^|  ^ ^  | |^ ^|   |  ^ ^ ^ ^
|  ^ ^ ^ ^  |  ^ ^  |  ^ ^ ^ ^ ^   ^ ^ ^ ^|  ^ ^ ^ ^ ^ ^  |^   ^ ^ ^ ^ ^  |  ^|  ^ ^|  ^ ^  |    ^ ^|  ^ ^ ^  |^ ^   ^ ^ ^|  ^ ^ ^ ^ ^ ^|  ^ ^ ^   ^ ^ ^ ^ ^ ^ ^  | |  ^ ^  |  ^ ^ ^