30
20
3
6
19
19
  | |       |   |     | |   |     |     |   | |             
|      ^ ^|    ^|  ^ ^   ^  |^|^     ^|^  |^   ^ ^ ^   ^|^| 
|^ ^|  ^ ^ ^|^ ^ ^ ^ ^ ^ ^     ^ ^   ^|^|   |^ ^   ^ ^ ^   ^
|^|  ^ ^   ^ ^|^ ^ ^   ^ ^ ^ ^ ^|  ^|^    | | |^ ^ ^ ^ ^ ^  
|   |^   ^|^   ^  |^| |^ ^ ^|^|^ ^|^ ^ ^ ^|^ ^| |^|^ ^ ^   ^
|^| |^  |^ ^ ^   ^   ^|^ ^     ^   ^   ^|  ^|      ^ ^|  ^ ^
|    ^ ^|^|^ ^ ^   ^ ^   ^ ^|^|^ ^ ^   ^ ^|^|  ^ ^|  ^|^ ^| 
| |^   ^|   |  ^|^ ^ ^|^ ^  | |^ ^ ^|^ ^|    ^| |  ^ ^   ^|^
|^ ^ ^ ^|^   ^|  ^|  ^  |^ ^   ^   ^|^   ^ ^   ^ ^ ^ ^  |^  
| |^  |^  |^ ^ ^  |^  |^ ^ ^ ^|^   ^|^  |^ ^ ^   ^ ^|^| |^  
|  ^| | |^ ^ ^|^ ^ ^|^|^   ^ ^ ^ ^  |^ ^ ^ ^  |^ ^  |  ^  | 
|  ^ ^  |  ^ ^ ^|^     ^ ^ ^ ^|^ ^  |^ ^ ^|^|^|  ^ ^|^ ^|  ^
| |^|^|^ ^ ^|^   ^ ^ ^|^ ^ ^  |^|^  | |^      |^  |^ ^    |^
| | |  ^   ^ ^|^|^   ^|  ^|^|     |^ ^|^|^   ^|  ^ ^ ^ ^    
|^   ^ ^|^|^  |  ^   ^   ^| | |  ^ ^  | |^| |^|^ ^| | | |  ^
|  ^ ^|^|    ^  |^ ^ ^ ^ ^   ^|^   ^|^|   | | |  ^ ^   ^ ^| 
|  ^ ^  |^   ^ ^ ^|^ ^|^|^   ^  |^ ^  | |      ^ ^ ^ ^ ^ ^  
|  ^|^   ^   ^ ^ ^| |      ^|^     ^ ^ ^|  ^ ^|^ ^ ^  |^|^ ^
|  ^|^  |^|  ^| |  ^ ^|^  | |  ^|  ^ ^|  ^|  ^|^ ^|^|      ^
|  ^ ^ ^   ^ ^ ^|  ^ ^|^  |  ^| |^ ^ ^ ^     ^| |    ^   ^ ^
